GRID
1 1 1 1 1 1 1 1 1 1 1 1 1 0 1 1 1 1 1 1 1 1 1 1 1
1 0 0 0 0 0 0 0 0 0 0 0 0 0 1 0 0 0 0 1 0 1 0 0 1
1 1 1 1 1 1 1 1 1 0 1 1 1 0 1 0 0 0 0 1 0 0 0 0 1
1 0 1 0 0 0 1 0 0 0 0 0 1 0 1 0 0 0 0 1 0 0 0 1 1
1 0 1 0 1 0 0 0 1 0 1 0 1 0 1 0 0 0 0 0 0 1 0 1 1
1 0 1 0 1 1 1 1 1 1 1 1 1 0 1 1 1 1 1 1 0 1 0 1 1
1 0 1 0 1 0 0 1 0 0 0 0 0 0 1 0 0 0 0 0 0 1 0 1 1
1 0 1 0 0 0 0 0 0 1 0 1 0 1 1 1 1 1 0 0 0 1 0 0 1
0 0 0 0 0 0 1 1 1 1 1 0 0 1 0 1 0 1 0 1 1 1 1 0 1
1 0 1 1 1 1 0 0 0 0 0 0 1 1 0 0 0 1 0 1 0 0 0 0 1
1 1 0 0 0 0 0 1 1 1 1 1 0 1 0 1 1 1 0 1 0 1 1 1 1
1 0 0 1 1 1 0 1 0 0 0 0 0 1 0 0 0 1 0 1 0 0 0 0 1
1 0 0 1 0 0 0 1 0 0 1 0 1 1 0 1 1 1 0 1 1 1 1 0 1
1 0 1 1 0 1 0 1 0 1 1 0 0 1 0 0 0 0 0 0 0 0 1 0 1
1 0 0 1 0 1 0 1 0 0 1 0 0 1 0 0 1 1 1 1 1 0 1 0 1
1 1 1 1 0 1 0 1 1 0 1 0 1 1 1 0 1 0 0 0 1 0 1 0 1
1 0 0 0 0 0 0 0 0 0 1 0 0 0 0 0 0 0 0 0 1 0 1 0 1
1 1 1 1 1 1 1 1 1 1 1 1 1 1 1 1 1 1 1 1 1 1 1 0 1 

PORTAL 0 8 src/levels/spawn.txt 23 8 LOCKED 7
PORTAL 13 0 src/levels/basement.txt 13 16 UNLOCKED 0
PORTAL 23 17 src/levels/office.txt 13 16 UNLOCKED 0

CHEST 15 2 111 2 Strength_Potion
CHEST 2 14 112 1 Health_Potion
CHEST 19 15 113 3 Defence_Potion

ENEMY 17 3 309 2
ENEMY 5 7 310 1
ENEMY 1 16 311 1
ENEMY 14 10 312 2
ENEMY 6 1 313 2

SIGNPOST 2 8 1
One way entrance to Cell Room.
